BugsScript1	"non matching brakets in command"
BugsScript2	"non closed quote in command"
BugsScript3	"non closed quote in command"
BugsScript4	"non matching square brakets in command"
BugsScript5	"both single and double quotes in command"

BugsCheck1	"array index less than one"
BugsCheck2	"array index greater than array upper bound for ^0"

BugsCodegen1	"logical expression contains too many constants"
BugsCodegen2	"logical expression contains too many operators"
BugsCodegen3	"logical expression contains too many operators"
BugsCodegen4	"logical expression contains too many operators"
BugsCodegen5	"logical expression contains too many operators"
BugsCodegen6	"logical expression contains too many operators"
BugsCodegen7	"logical expression contains too many operands"
BugsCodegen8	"logical expression contains too many operators"
BugsCodegen9	"logical expression contains too many operators"
BugsCodegen10	"logical expression contains too many operands"
BugsCodegen11	"logical expression contains too many operands"
BugsCodegen12	"vector valued logical expression must have more than one component"
BugsCodegen13	"scalar valued logical expression cannot have more than one component"
BugsCodegen14	"multivariate distribution must have more than one component"
BugsCodegen15	"univariate distribution can not have more than one component"

BugsCompiler1	"unable to generate initial values in allowed number of attempts"

BugsEvaluate1	"integer divide by zero"
BugsEvaluate2	"variable ^0 is not defined"
BugsEvaluate3	"missing index"
BugsEvaluate4	"invalid use of range construct in ^0"
BugsEvaluate5	"array index greater than array upper bound for ^0"
BugsEvaluate6	"variable ^0 not data"
BugsEvaluate7	"variable ^0 not defined in index expression"
BugsEvaluate8	"array index is not an integer"
BugsEvaluate9	"array index is greater than array upper bound for ^0"
BugsEvaluate10	"invalid range specified"
BugsEvaluate11	"array index is less than one"
BugsEvaluate12	"array index is less than one"
BugsEvaluate13	"array index is greater than array upper bound for ^0"
BugsEvaluate14	"made use of undefined node ^0"
BugsEvaluate15	"array index is greater than array upper bound for ^0"
BugsEvaluate16	"invalid range specified"
BugsEvaluate17	"array index is less than one"
BugsEvaluate18	"the vector quantity ^0 is not defined"
BugsEvaluate19	"the vector quantity ^0 has an undefined component"

BugsMask1	"array index of ^0 is less than one"
BugsMask2	"array index of ^0 is greater than array upper bound"
BugsMask3	"invalid index range specified for ^0"
BugsMask4	"array index of ^0 greater than array upper bound"
BugsMask5	"variable name ^0 must begin with a character"
BugsMask6	"name ^0 does not occur in model"

BugsInterface1	"unable to create updater for ^0"
BugsInterface2	"unable to generate initial values"

BugsNodes1	"array index is greater than array upper bound for ^0"
BugsNodes2	"array index is greater than array upper bound for ^0"
BugsNodes3	"variable ^0 is not defined in model or in data set"
BugsNodes4	"vector valued relation ^0 must involve consecutive elements of variable"
BugsNodes5	"multiple definitions of node ^0"
BugsNodes6	"vector valued relation ^0 must involve consecutive elements of variable"
BugsNodes7	"multiple definitions of node ^0"
BugsNodes8	"expected multivariate node"
BugsNodes9	"unable to create stochastic node ^0 with these options"

BugsParser1	"unknown type of logical function"
BugsParser2	"link function cannot be used on right hand side"
BugsParser3	"expected left parenthesis"
BugsParser4	"unknown type of argument for logical function"
BugsParser5	"expected comma"
BugsParser6	"expected right parenthesis"
BugsParser7	"expected left parenthesis"
BugsParser8	"expected comma"
BugsParser9	"expected right parenthesis"
BugsParser10	"unexpected token in factor"
BugsParser11	"logical function not allowed in integer expression"
BugsParser12	"expected right parenthesis"
BugsParser13	"expected variable name"
BugsParser14	"expected comma"
BugsParser15	"expected right square bracket"
BugsParser16	"expected an integer"
BugsParser17	"expected a number"
BugsParser18	"invalid or unexpected token scanned"
BugsParser19	"unknown type of probability density"
BugsParser20	"expected left parenthesis"
BugsParser21	"expected variable name"
BugsParser22	"unknown type of argument in probability density"
BugsParser23	"expected a comma"
BugsParser24	"expected right parenthesis"
BugsParser25	"this density cannot be censored"
BugsParser26	"expected left parenthesis"
BugsParser27	"expected comma"
BugsParser28	"expected right parenthesis"
BugsParser29	"loop index must be a name"
BugsParser30	"loop index cannot be a name of a variable in the model"
BugsParser31	"loop name already used in outer loop"
BugsParser32	"expected left parenthesis"
BugsParser33	"expected the key word in"
BugsParser34	"expected a colon"
BugsParser35	"expected right parenthesis"
BugsParser36	"expected an open brace {"
BugsParser37	"empty slot not allowed in variable name"
BugsParser38	"expected left pointing arrow <-"
BugsParser39	"expected left pointing arrow <- or twiddles ~"
BugsParser40	"unknown type of logical function"
BugsParser41	"function is not a link function"
BugsParser42	"expected right parenthesis"
BugsParser43	"expected left pointing arrow <-"
BugsParser44	"expected left pointing arrow <-"
BugsParser45	"invalid or unexpected token scanned"
BugsParser46	"this density cannot be truncated"
BugsParser47	"this density already censored"
BugsParser48	"this density already truncated"

BugsRectData1	"invalid or unexpected token scanned"
BugsRectData2	"NA cannot be given a sign"
BugsRectData3	"expected a number or an NA or END"
BugsRectData4	"expected a closing square bracket ]"
BugsRectData5	"column label cannot be a scalar"
BugsRectData6	"first slot of column label must be empty"
BugsRectData7	"second and later slots of column label must not be empty"
BugsRectData8	"unable to evaluate column label index"
BugsRectData9	"column label index is greater than array upper bound"
BugsRectData10	"range operator not allowed in column lables"
BugsRectData11	"data value already given for this component"
BugsRectData12	"incomplete row of data"
BugsRectData13	"wrong number of rows of data"
BugsRectData14	"no prior specified for this initial value"
BugsRectData15	"initial value given for non stochastic node"
BugsRectData16	"initial value given for data node"
BugsRectData17	"incomplete row of initial values"

BugsSplusData1	"invalid or unexpected token scanned"
BugsSplusData2	"NA cannot be given a sign"
BugsSplusData3	"expected a number or an NA"
BugsSplusData4	"data value already given for this component of node"
BugsSplusData5	"expected a comma or right parenthesis"
BugsSplusData6	"number of  items not equal to size of node"
BugsSplusData7	"node dimension does not match"
BugsSplusData8	"no prior specified for this node"
BugsSplusData9	"no prior specified for this component of node"
BugsSplusData10	"this component of node is not stochastic"
BugsSplusData11	"this component of node is data"
BugsSplusData12	"expected a comma or right parenthesis"
BugsSplusData13	"number of  items not equal to size of node"
BugsSplusData14	"expected a comma or right parenthesis"
BugsSplusData15	"node dimension does not match"
BugsSplusData16	"expected a period"
BugsSplusData17	"expected key word Dim"
BugsSplusData18	"expected an equals sign"
BugsSplusData19	"expected collection operator c"
BugsSplusData20	"expected left parenthesis"
BugsSplusData21	"expected an integer"
BugsSplusData22	"expected a comma or right parenthesis"
BugsSplusData23	"expected a comma"
BugsSplusData24	"expected right parenthesis"
BugsSplusData25	"scalar node must have size of one"
BugsSplusData26	"expected the collection operator c"
BugsSplusData27	"expected left parenthesis"
BugsSplusData28	"size of node not equal to number of components"	
BugsSplusData29	"expected key word structure"
BugsSplusData30	"expected left parenthesis"
BugsSplusData31	"expected a period"
BugsSplusData32	"expected key word Data"
BugsSplusData33	"expected an equals sign"
BugsSplusData34	"expected the collection operator c"
BugsSplusData35	"expected left parenthesis"
BugsSplusData36	"expected a comma"
BugsSplusData37	"number of  items not equal to size of node"
BugsSplusData38	"expected right parenthesis"
BugsSplusData39	"expected variable name"
BugsSplusData40	"undefined variable"
BugsSplusSata41	"expected an equals sign"
BugsSplusData42	"expected a comma or right parenthesis"
BugsSplusData43	"expected a comma"
BugsSplusData44	"expected key word list"
BugsSplusData45	"expected left parenthesis"
BugsSplusData46	"expected key word list"
BugsSplusData47	"expected left parenthesis"

BugsVariables1	"loop index must be a name"
BugsVariables2	"missing closing square bracket ]"

"BugsCmds:OkSyntax"	"model is syntactically correct"
"BugsCmds:OkData"	"data loaded"
"BugsCmds:OkCompile"	"model compiled"
"BugsCmds:UninitOther"	"initial values loaded but this or another chain contain uninitialized variables"
"BugsCmds:OkInits"	"model is initialized"
"BugsCmds:OkGenInits"	"initial values generated, model initialized"
"BugsCmds:UpdatesTook"	"^0 updates took ^1 s"
"BugsCmds:Updating"	"model is updating"

"BugsCmds:NoFile"	"file ^0 does not exist"
"BugsCmds:NoCheckData"	"model must be checked before data is loaded"
"BugsCmds:NoCheckCompile"	"model must be checked before compiling"
"BugsCmds:NoCompileInits"	"model must be compiled before initial values loaded"
"BugsCmds:NoCompileGenInits"	"model must be compiled before generating initial values"
"BugsCmds:AlreadyInits"	"model is already initialized"
"BugsCmds:NotInits"	"model must be initialized before updating"
"BugsCmds:SeedZero"	"seed of random number generator must not be zero"
"BugsCmds.AlreadyCompiled"	"this option can not be changed once the model is compiled"


"BugsEmbed:OkSyntax"	"model is syntactically correct"
"BugsEmbed:OkData"	"data loaded"
"BugsEmbed:OkCompile"	"model compiled"
"BugsEmbed:UninitOther"	"initial values loaded but this or another chain contain uninitialized variables"
"BugsEmbed:OkInits"	"model is initialized"
"BugsEmbed:OkGenInits"	"initial values generated, model initialized"
"BugsEmbed:UpdatesTook"	"^0 updates took ^1 s"
"BugsEmbed:Updating"	"model is updating"

"BugsEmbed:NoFile"	"file ^0 does not exist"
"BugsEmbed:NoCheckData"	"model must be checked before data is loaded"
"BugsEmbed:NoCheckCompile"	"model must be checked before compiling"
"BugsEmbed:NoCompileInits"	"model must be compiled before initial values loaded"
"BugsEmbed:NoCompileGenInits"	"model must be compiled before generating initial values"
"BugsEmbed:AlreadyInits"	"model is already initialized"
"BugsEmbed:NotInits"	"model must be initialized before updating"
"BugsEmbed:SeedZero"	"seed of random number generator must not be zero"
"BugsEmbed.AlreadyCompiled"	"this option can not be changed once the model is compiled"
"BugsEmbed:chainsWrittenOut"	"chains written out"
END